{
  "_comment": "Hand-authored M1 sample (NOT from an .h3m). Terrain ids are canonical HoMM3 values: 0 dirt, 1 sand, 2 grass, 5 rough, 8 water. 16x12, a grass field with a sand-ringed lake. Replaced by tooling/h3m_to_json.py output later.",
  "name": "Sample Vale",
  "tiles": [
    [2, 2, 2, 2, 2, 2, 2, 2, 2, 2, 2, 2, 2, 2, 2, 2],
    [2, 2, 2, 2, 2, 5, 5, 2, 2, 2, 2, 2, 2, 2, 2, 2],
    [2, 2, 2, 2, 5, 5, 2, 2, 2, 2, 1, 1, 1, 2, 2, 2],
    [2, 2, 2, 2, 2, 2, 2, 2, 2, 1, 1, 8, 1, 1, 2, 2],
    [2, 2, 0, 0, 2, 2, 2, 2, 1, 1, 8, 8, 8, 1, 2, 2],
    [2, 2, 0, 0, 2, 2, 2, 2, 1, 1, 8, 8, 8, 1, 2, 2],
    [2, 2, 2, 2, 2, 2, 2, 2, 1, 1, 8, 8, 1, 1, 2, 2],
    [2, 2, 2, 2, 2, 2, 2, 2, 2, 1, 1, 1, 1, 2, 2, 2],
    [2, 2, 2, 5, 5, 2, 2, 2, 2, 2, 2, 2, 2, 2, 2, 2],
    [2, 2, 2, 5, 2, 2, 2, 2, 2, 2, 2, 2, 2, 2, 2, 2],
    [2, 2, 2, 2, 2, 2, 2, 2, 2, 2, 2, 2, 2, 2, 2, 2],
    [2, 2, 2, 2, 2, 2, 2, 2, 2, 2, 2, 2, 2, 2, 2, 2]
  ],
  "objects": []
}
